# Syntax Colouring Map For libcndn

# Data types (KEYWORD1)
CNTimeout	KEYWORD1
CNDigital	KEYWORD1
CNPIN	KEYWORD1

# Methods and Functions (KEYWORD2)
update	KEYWORD2
lastms	KEYWORD2
reset	KEYWORD2
disable	KEYWORD2
isTimeout	KEYWORD2
isEnable	KEYWORD2

get	KEYWORD2
set	KEYWORD2
count	KEYWORD2
isPress	KEYWORD2
isDownOnce	KEYWORD2
isOn	KEYWORD2
isOnOnce	KEYWORD2
isUpOnce	KEYWORD2
isOff	KEYWORD2
isOffOnce	KEYWORD2
isOnTime	KEYWORD2
isOffTime	KEYWORD2

# Constants (LITERAL1)
START_POS LITERAL1
GET_ARG LITERAL1
NEXT_POS LITERAL1
